000010000
000011110
011110010
010000010
011111110
000000010
011111110
010000000
011111111
000000001