000010000
000011111
000000001
011111111
010000000
011111110
000000010
000000010