0000010000
0000010000
0111111100
0100000100
0111110100
0000010100
0111110111
0100000001
0111111111
0000000001